11111111
1PE00001
11100001
100CCCC1
10001111
11111111