11111111
1P000001
11000001
100011C1
1000E111
11111111