111111111111
100C00000001
100000P00011
111100000111
1000C00C01C1
100000000011
10000C000001
10000C000001
101111111111
1000E0000111
100000000001
111111111111