11111111111111111
10P00010000000CC1
1C000010000110011
10010000CCCC00001
11110000000000011
10C100CCC00111111
10000000000000111
11111110000000011
10000000000000011
1000E000C00CCCC01
10000000000000111
11111111111111111