111111111
100006601
10000P001
10000C001
100006601
10000E601
111111111