111111111111
100000000001
100000P00011
111100000111
100000000001
100000001111
1000E0000111
100000000001
111111111111