10001100
10000010
10000000000
1111111110
1000111111