11111111
10000001
10000000
100PEC01
11111111