111111111111
100C00000001
100000P0E011
1111000C0111
1000C00C0001
100000001111
1000E0000111
100000000001
111111111111